0000000000000000000000000000000
I                             0
0                             0
0                             0
0                             0
0                             0
0                E            0
0                             0
0                             0
0                             0
0                             0
0                             0
0                             0
0000000000000000000000000000000

